50 50
1 1 1 1 1 1 1 1 1 1 1 1 1 1 1 1 1 1 1 1 1 1 1 1 1 1 1 1 1 1 1 1 1 1 1 1 1 1 1 1 1 1 1 1 1 1 1 1 1 1
1 2 3 4 5 6 7 8 0 0 0 0 0 0 0 2 3 4 5 0 0 0 0 0 0 0 1 0 0 0 0 0 0 1 1 1 1 1 1 1 1 1 1 1 1 1 1 1 1 1
1 0 0 0 0 0 0 0 0 3 3 3 3 3 0 0 0 0 0 0 6 7 8 7 0 0 1 0 1 1 1 1 0 1 1 1 1 1 1 1 1 1 1 1 1 1 1 1 1 1
1 0 1 1 1 1 1 1 1 1 1 1 1 1 0 1 0 1 1 1 1 1 1 1 1 0 1 0 1 2 0 1 0 1 1 1 1 1 1 1 1 1 1 1 1 1 1 1 1 1
1 0 0 0 0 0 0 0 0 0 1 0 0 0 0 1 0 1 1 1 8 1 0 0 0 0 1 0 1 2 0 1 0 1 1 1 1 1 1 1 1 1 1 1 1 1 1 1 1 1
1 1 1 1 1 1 1 1 1 0 1 0 1 1 1 1 0 1 0 0 0 1 0 1 1 0 1 0 1 2 0 1 0 1 1 1 1 1 1 1 1 1 1 1 1 1 1 1 1 1
1 1 1 1 1 1 1 1 1 0 1 0 1 0 0 1 0 1 1 1 0 1 0 0 1 0 1 0 1 2 0 1 0 1 1 1 1 1 1 1 1 1 1 1 1 1 1 1 1 1
1 1 1 1 1 1 1 1 1 0 1 0 1 0 1 1 0 1 1 1 0 1 1 0 1 0 1 0 1 2 0 1 0 1 1 1 1 1 1 1 1 1 1 1 1 1 1 1 1 1
1 1 1 1 1 1 1 1 0 0 1 0 1 0 1 1 0 0 0 0 0 0 0 0 1 0 0 0 0 0 0 1 0 1 1 1 1 1 1 1 1 1 1 1 1 1 1 1 1 1
1 1 1 1 1 1 1 1 0 1 1 0 1 0 1 1 1 1 1 1 1 1 1 1 1 0 1 1 1 1 1 1 0 1 1 1 1 1 1 1 1 1 1 1 1 1 1 1 1 1
1 1 1 1 1 1 1 1 0 1 0 0 0 0 0 0 0 0 0 0 0 0 0 0 0 0 0 0 0 0 0 0 0 0 0 0 0 0 0 0 1 1 1 1 1 1 1 1 1 1
1 1 1 1 1 1 1 1 0 1 0 5 5 5 5 5 5 5 5 5 5 5 5 5 5 0 5 5 5 5 5 5 5 5 5 5 5 5 5 0 1 1 1 1 1 1 1 1 1 1
1 1 1 1 1 1 1 1 0 1 0 5 0 0 0 0 0 0 0 0 0 0 0 0 0 0 0 0 0 0 0 0 0 0 0 0 0 0 5 0 1 1 1 1 1 1 1 1 1 1
1 1 1 1 1 1 1 1 0 1 0 5 0 2 2 2 2 0 5 0 5 5 7 0 8 8 0 0 0 0 0 0 5 0 0 0 0 0 5 0 1 1 1 1 1 1 1 1 1 1
1 1 1 1 1 1 1 1 0 1 0 5 0 0 0 0 2 0 5 0 5 0 7 0 8 8 0 0 0 0 0 0 5 0 0 0 0 0 5 0 1 1 1 1 1 1 1 1 1 1
1 1 1 1 1 1 1 1 0 1 0 5 0 2 2 0 2 0 5 0 5 0 7 0 7 7 0 0 0 0 0 0 5 0 0 0 0 0 5 0 1 1 1 1 1 1 1 1 1 1
1 1 1 1 1 1 1 1 0 1 0 5 0 0 2 0 2 0 5 0 5 0 7 0 7 7 0 0 0 0 0 0 5 0 0 0 0 0 5 0 1 1 1 1 1 1 1 1 1 1
1 1 1 1 1 1 1 1 0 1 0 5 2 0 2 0 2 0 5 0 5 0 7 0 7 7 0 0 0 0 0 0 5 0 0 0 0 0 5 0 1 1 1 1 1 1 1 1 1 1
1 1 1 1 1 1 1 1 0 1 0 5 2 0 2 0 2 0 5 0 0 0 7 0 7 7 0 0 0 0 0 0 5 0 0 0 0 0 5 0 1 1 1 1 1 1 1 1 1 1
1 1 1 1 1 1 1 1 0 1 0 5 2 0 2 0 2 0 5 0 7 7 7 0 7 7 0 0 0 0 0 0 5 0 0 0 0 0 5 0 1 1 1 1 1 1 1 1 1 1
1 1 1 1 1 1 1 1 0 1 0 5 0 0 2 0 2 0 5 0 0 0 0 0 6 6 0 0 0 0 0 0 5 0 0 0 0 0 5 0 1 1 1 1 1 1 1 1 1 1
1 1 1 1 1 1 1 1 0 1 0 5 2 0 0 0 2 0 5 0 6 6 6 6 6 6 0 0 0 0 0 0 5 0 0 0 0 0 5 0 1 1 1 1 1 1 1 1 1 1
1 1 1 1 1 1 1 1 0 1 0 5 2 2 2 2 2 0 5 0 0 0 0 0 5 5 0 0 0 0 0 0 5 0 0 0 0 0 5 0 1 1 1 1 1 1 1 1 1 1
1 1 1 1 1 1 1 1 0 1 0 5 0 0 0 0 0 0 5 6 6 6 6 0 5 5 0 0 0 0 0 0 5 0 0 0 0 0 5 0 1 1 1 1 1 1 1 1 1 1
1 1 1 1 1 1 1 1 0 1 0 5 3 0 1 1 1 1 5 0 0 0 0 0 5 5 0 0 0 0 0 0 5 0 0 0 0 0 5 0 1 1 1 1 1 1 1 1 1 1
1 1 1 1 1 1 1 1 0 1 0 5 0 0 1 0 0 0 5 0 4 4 4 4 5 5 0 0 0 0 0 0 5 0 0 0 0 0 5 0 1 1 1 1 1 1 1 1 1 1
1 1 1 1 1 1 1 1 0 1 0 5 0 3 1 0 1 1 5 0 0 0 0 0 5 5 0 0 0 0 0 0 5 0 0 0 0 0 5 0 1 1 1 1 1 1 1 1 1 1
1 1 1 1 1 1 1 1 0 1 0 5 0 0 1 0 0 0 5 0 3 0 3 0 5 5 0 3 0 0 0 0 5 0 0 0 0 0 5 0 1 1 1 1 1 1 1 1 1 1
1 1 1 1 1 1 1 1 0 1 0 5 3 0 1 0 3 3 5 0 3 0 3 4 4 4 4 3 0 0 0 0 5 0 0 0 0 0 5 0 1 1 1 1 1 1 1 1 1 1
1 1 1 1 1 1 1 1 0 1 0 5 0 0 1 0 3 0 5 X 3 0 0 0 0 0 0 0 0 0 0 0 5 0 0 0 0 0 5 0 1 1 1 1 1 1 1 1 1 1
1 1 1 1 1 1 1 1 0 1 0 5 0 3 1 0 3 0 5 0 1 1 1 1 1 1 1 1 1 1 0 0 5 0 0 0 0 0 5 0 1 1 1 1 1 1 1 1 1 1
1 1 1 1 1 1 1 1 0 1 0 5 0 0 1 0 3 0 5 0 1 1 1 1 1 1 1 1 1 1 0 0 5 0 0 0 0 0 5 0 1 1 1 1 1 1 1 1 1 1
1 1 1 1 1 1 1 1 0 1 0 5 3 0 1 0 0 0 5 0 1 1 1 1 1 1 1 1 1 1 0 0 5 0 0 0 0 0 5 0 1 1 1 1 1 1 1 1 1 1
1 1 1 1 0 0 0 1 0 1 0 5 0 0 1 0 3 0 5 0 1 1 1 1 1 1 1 1 1 1 0 0 5 0 0 0 0 0 5 0 1 1 1 1 1 1 1 1 1 1
1 1 1 1 0 1 1 1 0 1 0 5 0 3 1 0 3 0 5 0 1 1 1 1 1 1 1 1 1 1 0 0 5 3 3 3 0 3 5 0 1 1 1 1 1 1 1 1 1 1
1 1 1 1 0 1 1 1 0 1 0 5 0 0 1 0 3 0 5 0 1 1 1 1 1 1 1 1 1 1 0 0 5 0 0 2 0 0 5 0 1 1 1 1 1 1 1 1 1 1
1 1 1 1 0 1 1 1 0 1 0 5 3 0 1 0 0 0 5 0 1 1 1 1 1 1 1 1 1 1 0 0 5 0 0 2 0 0 5 0 1 1 1 1 1 1 1 1 1 1
1 1 1 1 0 1 1 1 0 1 0 5 0 0 2 2 0 0 5 0 1 1 1 1 1 1 1 1 1 1 0 0 5 0 0 2 0 0 5 0 1 1 1 1 1 1 1 1 1 1
1 1 1 1 0 1 1 1 0 1 0 5 0 3 0 0 3 0 5 0 1 1 1 1 1 1 1 1 1 1 0 0 5 0 0 2 0 0 5 0 1 1 1 1 1 1 1 1 1 1
1 1 1 1 0 1 1 1 0 1 0 0 0 0 0 0 0 0 0 0 1 1 1 1 1 1 1 1 1 1 0 0 0 0 0 0 0 0 0 0 1 1 1 1 1 1 1 1 1 1
1 1 1 1 0 1 1 1 0 1 1 1 1 1 1 1 1 1 1 1 1 1 1 1 1 1 1 1 1 1 1 1 1 1 1 1 1 1 1 1 1 1 1 1 1 1 1 1 1 1
1 1 1 1 0 1 1 1 0 1 1 1 1 1 1 1 1 1 1 1 1 1 1 1 1 1 1 1 1 1 1 1 1 1 1 1 1 1 1 1 1 1 1 1 1 1 1 1 1 1
1 1 1 1 0 1 1 1 0 1 1 1 1 1 1 1 1 1 1 1 1 1 1 1 1 1 1 1 1 1 1 1 1 1 1 1 1 1 1 1 1 1 1 1 1 1 1 1 1 1
1 1 0 0 0 0 0 1 0 1 1 1 1 1 1 1 1 1 1 1 1 1 1 1 1 1 1 1 1 1 1 1 1 1 1 1 1 1 1 1 1 1 1 1 1 1 1 1 1 1
1 1 0 1 1 1 0 1 0 1 1 1 1 1 1 1 1 1 1 1 1 1 1 1 1 1 1 1 1 1 1 1 1 1 1 1 1 1 1 1 1 1 1 1 1 1 1 1 1 1
1 1 0 1 0 1 0 1 0 1 1 1 1 1 1 1 1 1 1 1 1 1 1 1 1 1 1 1 1 1 1 1 1 1 1 1 1 1 1 1 1 1 1 1 1 1 1 1 1 1
1 1 0 1 0 0 0 1 0 1 1 1 1 1 1 1 1 1 1 1 1 1 1 1 1 1 1 1 1 1 1 1 1 1 1 1 1 1 1 1 1 1 1 1 1 1 1 1 1 1
1 1 0 1 1 1 1 1 0 1 1 1 1 1 1 1 1 1 1 1 1 1 1 1 1 1 1 1 1 1 1 1 1 1 1 1 1 1 1 1 1 1 1 1 1 1 1 1 1 1
1 0 0 0 0 0 0 0 0 1 1 1 1 1 1 1 1 1 1 1 1 1 1 1 1 1 1 1 1 1 1 1 1 1 1 1 1 1 1 1 1 1 1 1 1 1 1 1 1 1
1 1 1 1 1 1 1 1 1 1 1 1 1 1 1 1 1 1 1 1 1 1 1 1 1 1 1 1 1 1 1 1 1 1 1 1 1 1 1 1 1 1 1 1 1 1 1 1 1 1
